ALBERTI: MEDICI Marta
ARRECIFES: BOLINAGA Daniel Néstor
AVELLANEDA: FERRARESI Jorge
AZUL INZA: José Manuel
BAHIA BLANCA: BEVILACQUA Gustavo
BALCARCE: ECHEVERRIA José Enrique
BARADERO: CAROSSI Aldo Mario
BENITO JUAREZ: MARINI Julio
BERAZATEGUI: MUSSI Juan Patricio
BERISSO :SLEZACK Enrique
BOLIVAR: BUCCA Eduardo
BRAGADO: SAN PEDRO Aldo Omar
BRANDSEN: ARIAS Gastén
CAMPANA:GIROLDI Stella Maris
CANUELAS :FASSI: Marisa Viviana
CAPITAN SARMIENTO: OSTOICH Oscar
CARLOS CASARES:TORCHIO Walter
CARLOS TEJEDOR: GIANINI Maria Celia
CASTELLI: ECHARREN Francisco José
CHACABUCO’: BARRIENTOS Mauricio
CHIVILCOY: PITTELLI Anibal
COLON: CASI Ricardo Miguel
ENSENADA: SECCO Mario Carlos
ESTEBAN ECHEVERRIA: GRAY FERNANDO JAVIER
EXALT. DE LA CRUZ: SANCHEZ Adrian
EZEIZA: CICCO Oscar
FLORENCIO VARELA: PEREYRA Julio César
FLORENTINO AMEGHINO: IRIBARREN Francisco
GENERAL ARENALES: MEDINA José Maria
GENERAL BELGRANO: EIJO Jorge
GENERAL LA MADRID: PELLITA Juan Carlos
GENERAL LAS HERAS:CALO Juan Carlos
GENERAL MADARIAGA: POPOVICH Cristian
GENERAL PAZ: VERAMENDI Juan Carlos
GENERAL PINTO: GUERRERA’AIexis Ral’il
GENERAL PUEYRREDON: PULTI Gustavo Arnaldo
GENERAL RODRIGUEZ: ANGHILERI Juan Pablo
GENERAL VIAMONTE: BARTOLETTI Juan Carlos
GUAMINI: ALVAREZ Néstor
ITUZAINGO: DESCALZO Alberto Daniel
JOSE C. PAZ: URQUIAGA Carlos
LA COSTA: de JESUS Juan Pablo
LA MATANZA: ESPINOZA Tomas Fernando
LA PLATA: BRUERA Oscar Pablo
LANUS: DiAZ PEREZ Dario Rubén
LAPRIDA: FISHER Alfredo Rubén
LAS FLORES:GELENE Alberto César
LEANDRO N. ALEM: CONOCCHIARI Alberto Rubén
LEZAMA: RACCIATTI Marcelo
LINCOLN: FERNANDEZ Jorge Abel
LOBERIA: ARGUELLO Diana Edith
LOBOS: SOBREROGustavo Rubén
LOMAS DE ZAMORA: CARASATORE Santiago
MAGDALENA: CARBALLO Fernando
MAR CHIQUITA: PAREDI Jorge Alberto
MARCOS PAZ: CURUTCHET Ricardo Pedro
MONTE:BASUALDO Raul Alberto
MONTE HERMOSO: FERNANDEZ Marcos
MORENO: WEST Mariano
NAVARRO: MAGGIOTTI Santiago
NECOCHEA: VIDA’L Jose Luis
PATAGONES: CURETTI Ricardo
PEHUAJO:ZURRO Pablo Javier
PILA :WALKER Gustavo Alfredo
PRESIDENTE PERON: BIROULET Carina
PUNTA INDIO: YZURIETA Hernan
QUILMES: GUTIERREZ Francisco Virgilio
RAUCH: UGARTE Jorge Mario
ROQUE PEREZ: GASPARINI Juan Carlos
SAAVEDRA: CORVATTA Hugo
SALTO: BRASCA Oscar René
SAN ANTONIO DE ARECO: DURANONA Francisco
SAN NICOLAS: PASSAGLIA Ismael
SAN PEDRO:GUACONE Pablo
SAN VICENTE: DI SABATINO Antonio Daniel
SUIPACHA: DELFINO Juan Antonio
TAPALQUE: COCCONI Gustavo Rodolfo
TORDILLO: OLIVERA Héctor Anibal
TORNQUIST: TRANKELSGustavo Guillermo
TRES DE FEBRERO: CURTO Hugo Omar
TRES LOMAS: ALVAREZ: Roberto
VILLA GESELL: RODRIGUEZ ERNETA Jorge Luis 
VILLARINO: COBELLO Patricia
